┌─────┬───────────┐
│  @  │           │
│     │           │
│     │           │    Hello there.
│           │     │    Cursor keys.
│           │     │
│           │  █  │
└───────────┴─────┘

