┌─────────────┬───────┐
│  @          │   █   │
│             │       │
│             │       │
│             │       │
│             │       │
│             │       │
│                     │
│                     │
│                     │
│          ▴          │
└──────────┴──────────┘


