┌─────────┬──────────┐
│                    │
│  @              █  │
│                    │
│         ╻          │
├        ╺┼╸    ┤    │
│         ╹          │
│                    │
│                    │
│         ┴          │
│                    │    Press Z if you get stuck.
└────────────────────┘


