┌────────────────┬─────┐
│  @             │  █  │
│                │     │
│                │     │
│                │     │
│                │     │
│                │     │
│                │     │
│                │     │
│                      │
│          ▴           │
└──────────┴───────────┘


