┌───────────┬─────┐
│                 │
│  @           █  │
│                 │
│           ?     │
│                 │
│                 │
│  x              │
│                 │
│                 │
│           ^     │
└───────────┴─────┘

