┌─────────┬──────────┐
│                    │
│  @              █  │
│         ?          │
│                    │
│                    │
│  x                 │
│                    │
│         ^          │
└─────────┴──────────┘

