┌─────┬─────┬─────┐
│     │     │     │
│  x  │     v     │
│  @  │           │
│     │           │
│     │           │
│     │           │
│     │           │
│     │           │
│     │     ?     │
│     ├> ?        ┤
│     │           │
│     │  █        │
│     │           │
│     │           │
│     │           └───────────┐
│     │                       │
│     ├                      <┤
│     │                       │
│     │           ┌───────────┘
│                 │
│                 │
└─────┴─────┴─────┘


