┌───┬─────┬─────────┐
│@x │     │         │
├── └─┬─┐ └──────── │
│     │ │           │
├─┐?──┘ └───────────┤
│ ├x    ! ! ! <=====┤
│ └──── ────────────┤
│   x               │
├────────────────── │
├>? ? ? ? ? ? ? ? ? ┤
├─────────────────┐ │
│                 │█│
└─────────────────┴─┘
